1111111111111111111111111111111111
10000000000000D0000C0000D000010001
1000000000000000000000000000010101
1000000000000000000000000000010101
1000000000000000000000000000100101
10000000000C0000000000000001001001
100C0000P0000000000000000010010011
1101110000100000000000000010100111
1E00000C000000000000000000001C0111
1111111111111111111111111111111111
