11111111111
11110C01111
11110001111
11110001111
10000001111
10000000001
1CH00P000E1
10000000001
1111D001111
11110001111
11110E01111
11111111111
