111111111111111111
1E000001C000010C01
10P000001000010001
10C0000000000100C1
100000D0000D000011
100000000000001111
1000000000000000E1
111111111111111111
